PPPPPPPPPPPPPPPPPPPPPPPPPPPPPPPPPPPPPPPPPPPPPPPPPPPPPPPPPPPPPPPPPPPPPPPPPPPPPPPPPPPPPPPPPPPPPPPPPPPP
PPPPPPPPPPPPPPPPPPPPPPPPPPPPPPPPPPPPPPPPPPPPPPPPPPPPPPPPPPPPPPPPPPPPPPPPPPPPPPPPPPPPPPPPPPPPPPPPPPPP
PPPPPPPPPPPPPPPPPPPPPPPPPPPPPPPPPPPPPPPPPPPPPPPPPPPPPPPPPPPPPPPPPPPPPPPPPPPPPPPPPPPPPPPPPPPPPPPPPPPP
PPPTTTSSTTTSSTTTTTTTTTTTTTSSTTTTTTTTTTTTTTTTTTTTTTTTTTTTTTTTTTSSTTTTAATTTTTTTTTTTTTTTTTTTTSSTTTTKPPP
PPPTTTSSTTTTSSTTTTTTTTTTTTSSTTTTTTTTTTTTTTTTTTTTTTTTTTTTTTTTTTTSSTTAATTTTTTTTTTTTTTTTTTTTSSTTTTTTPPP
PPPTTTTSSTTSSTTTTTTTTTTTTTTSSTTTTTTTTTTTTTTTTTTTTTTTTTTTTTTTTTBSSBBAABBBTTTTTTTTTTTTTTTTTSSTTTTTKPPP
PPPTTTTSSTSSTTTTTTTTTTTTTTTSSTTTTTTTTTTTTTTTTTTTTTTTTTTTTTTTTTSSSSBBAABBTTTTTTTTTTTTTTTTTSSTTTTTTPPP
PPPTTTTSSTTSSTTTTTTTTTTTTTTTSSTTTTTTTTTTTTTTTTTTTTTTTTTTTTTTTTBSSBBAABBBTTTTTTTTTTTTTTTTTSSTTTTTTPPP
PPPSTTSSTTTSSTTTTTTTTTTTTTTTSSTTTTTTTTTTTTTTTTTTTTTTTTTTTTTTTTSSBBAABBBBTTTTTTTTTTTTTTTTTTSSTTTTTPPP
PPPSSTTSSTSSSSSSTTTTTTTTTTTTTSSTTTTTTTTTTTTTTTTTTTTTTTTTTTTBBBBSSAABBBBSSSSSSSSSSSSSSTTTTTTSSTTTTPPP
PPPTSSSSSSSSSSSSSSTSTSTTTTTTTTSSTTTTTTTTTTTTTTTTTTTTTTTTTTTBBBBBSSBBBBBSSSSSSSSSSSSSSTTTTTTSSTTTTPPP
PPPTTSSTTSSSTTTTSSSSSSSSSTTTTTSSTTTTTTTTTTTTTTTTTTTTTTTTTTTBBBBSSAABBBBSSSAAAAAAAASSSBBTTTTSSTTTTPPP
PPPTTTSSTTTSSTTTTTSTSTSSSSSTTSSTSTTTTTTTTTTTTSSTTTTTTTTTTTTBBBBBSSBBBBBSSSSSSSSSSSSSSBBTTTTSSTTTTPPP
PPPTTTSSTTSSTTTTTTTTTTTTTSSSTTSSSSTTTTTSTTTTSSSSKTTTTTTTTTTBBBBSSBBBBBBSSSAAAAAAAASSSBBTTTTSSTTTTPPP
PPPTTSSTTSSTTTTTTTTTTTTTTTTSSSSSTSSTTTSSSSTSSTTSSSTTTTTTTTTBBBBBSSBBBBBSSSSSSSSSSSSSSBBTTTSSTTTTTPPP
PPPTTSSTSSTTTTTTTTTTTTTTTTTTSSTTTTSSTSSTSSSSTTTTSSSSSTSTTTTBBBBSSSSBBBBSSSAAAAAAAKSSSBBTTTTSSTTTTPPP
PPPTTTSSSSTTTTTTTTTTTTTTTSSSSSSSSSSSSSSTTTSTTTTTTTSSSSSSTTTBBBBSSSSBBBBSSSSSSSSSSSSSSBBTTTSSTTTTTPPP
PPPTTTTSSTTTTTTTTTTTTTTTTSSSSSSSSSSSSSSTTTTTTTTTTTTTTSTSSSTBBBBSSSSBBBBSSSAAAAAAAASSSBBTTTTSSTTTTPPP
PPPTTTSSSSTTTTTTTTTTTTTTTSSAAAAAAAAAASSTTTTTTTTTTTTTTTTTSSSBBBBBSSBBBBBSSSSSSSSSSSSSSBBTTTTSSTTTTPPP
PPPTTTTTSSTTTTTTTTTTTTTTTSSAAAAAAAAAASKTTTTTTTTTTTTTTTTTTTSSBBBSSSBBBBKSSSAAAAAAAASSSBBTTTTTSTSTTPPP
PPPTTTTSSSSTTTTTTTTTTTTTTSSAAAAAAAAAASSTTTTTTTTTTTTTTTTTTTTSSBSSSSSBBBBSSSSSSSSSSSSSSBBTTTTSSSSSTPPP
PPPTTTSSSSTTTTTTTTTTTTTTTSSAAASSSSAAASSTTTTTTKTTTTTTTTTTTTTBSSSBSSSSSBBSSSSSSSSSSSSSSSSSSSSSTSTSSPPP
PPPTTTTSSSSTTTTTTTTTTTTTTSSAAASTTSAAASSTTTTTTTTTTTTTTTTTTTTBBSBBBSSSSSSSSSSSSSSSSSSSSSMMMMMMSSTTSPPP
PPPTTTTSSTSSTTTTTTTTTTTTTSSAAASTTSAAASSTTTTTTTTTTTTTTTTTTTTBBBBBAASSBSSSSSSSSSSSSSSSBSMAAAAMSSTSTPPP
PPPSSSSSSSSSSSSSSSSSKTTTTSSAAASSSSAAASSTTTTTTTTTTTTTTTTTTTTBBBBAABBSSSBSSSBBSSSSBBSSBSMAAAAMSSSSTPPP
PPPSSSSSSSSSSSSSSSSSTTTTTSSAAAAAAAAAASSTTTTTTTTTTTTTTTTTTTTBBSSBAASSSSBBBBBBBBBBBBBBBSMAAAAMSSSTTPPP
PPPSAAAAAAAAAASSSSSSTTTTTSSAAAAAAAAAASSTTTTTTTTTTTTTTTTTTTTSSSSAASSBSBBBBBBBBBBBBBBBBSMAAAAMSSTTTPPP
PPPAAAAAAAAAAAAASSSSTTTTTSSAAAAAAAAAASSTTTTTTTTTTTTTTTTTSTSSSTTAATSSTTTTTTTTTTTTTTTTTSMAAAAMTSSTTPPP
PPPAAAAAAAAAAAAAASSSSSSSSSSSSSSSSSSSSSSTTTTTTTTTTTTTTTTSSSSTTTAASSTSSTTTBBBBBBBBBBBBBSMAAAAMTTSSTPPP
PPPAAAASAASSSAAAASSSSSSSSSSSSSSSSSSSSSSTTTTTTTTTTTTTTTSSTSTTTAATTSSSSTTTBBBBBBBBBBBBBSMAAAAMTTTSSPPP
PPPAAAASSSSSSSAAASSSSSSSSSSTTTTTTTTTTTTTTTTTTTTTTTTTTSSTTTTTTTAATTSSTTTTBBBBAAAAAABBBSMAAAAMTTSSTPPP
PPPAAAASSSSSSSAAAASSSSSSSSTTTTTTTTTTTTTTTTTTTTTTTTSTSSTTTTTTTTAATSSSSTTTBBBAAAAAAAABBSMAAAAMTTSSTPPP
PPPAAAASSSAAAAAAAAASSSSSSSBBBTTTTTTTTTTTTTTTTTTTTSSSSTTTTTTTTTTAATSSTTTTBBAAAAAAAAABBSMAAAAMTTTSSPPP
PPPAAAASASSAAAAAAAASSSSSSSSBBTTTTTTTTTTTTTTTTTSTSSTSTTTTTTTTTTAATSSTTTTTBBAAAAAAAAABBSMAAAAMTTTSSPPP
PPPAAAAAAAAAAAAAAAASSSSSSSSSSSSSSSSSSSSSSSSSTSSSSTTTTTTTTTTTTTAATSSTTTBBBBAAAAAAAAABBSMAAAAMTTSSTPPP
PPPAAAAAAAAAAAAAAAASSSSSMMMMMMMMMMMMMMMMSSSSSSTSTTTTTTTTTTTTTTAASSSSTTBBBBAAAAAAAABBBSMAAAAMTTTSSPPP
PPPSSSAAAAAAAAAAAASSSSSSMSSSSSSSSSSSSSSMSTTTSTTTTTTTTTTTTTTTTTTAATSSTTBBBBBBAAAAABBBBSMAAAAMTTSSTPPP
PPPSSSSSAAAAAAAAASSSSSSSMSSSSSSSSSSSSSSMSTTTTTTTTTTTTTTTTTTTTTTTAASSTTBBBBBBBBBBBBBBBSMMMMMMTSSTSPPP
PPPSSSSSSSSAAASSSSSSSSSSMSSSSSSSSSSSSSSMSTTTTTTTTTTTTTTTTTTTTTTAASSTTTBBBBBBBBSSBBBBBSSSSSTSSSSSSPPP
PPPSSSSSSSSSSSSSSSSSSSSSMSSSSSSSSSSSSSSMSTTTTTTTTTTTTTTTTTTTTTTTTSSTTTBBBBBBBSSSSBBBBBBBTTSSSSTSSPPP
PPPSSSSSSSSSSSSSSSSSSBBSMSSSSSBBBBBSSSSMSTTTTTTTTTTTTTTTTTTTSSTTAASSTTBBSBBBSSBBSSBBBBBBTSSTTTTTTPPP
PPPSSSBSBSSSSSSSSSSSSSBSMSSSSBBTTTBSSSSMSSTTTTTTTTTTTTTTTTSSSSSSTSSSTTBSSBSSSBBBBSSSSSBSSSTTTTTTTPPP
PPPTTTBBBBBSSBBBBBBBBSSSMSSSSBBBBBBSSSSMSSTTTTTTTTTTTTTTTSSSSTSSSSTSSTSSBSSSBBBBBBSSSSSSSSTTTTTTTPPP
PPPTTBBBBBSSBSBBBSBBBSSSMSSSSBTBBTBSSSSMSSSSSSSSSSSSSSSSSSTTSTTTSSSSSSSSSSSSSBBBBBBBBBSBSSTTTTTTTPPP
PPPSTBBBBBSSSSSBSSSBSSBSMSSSBBBBBBBSSSSMMMMMMMMMMMMMMMMMSTTTTTTTTSSTTSSSSBSSSSSSBBBBBBTTSSTTTTTTTPPP
PPPSSBBBBSSSSBSSSBSSSBBSMSSSSBBBBBBBSBBBBBBBBBBBTTSSSSSMSTTTTTTTTSSTTTSBBBBBBSSSSBBBBBTTSSTTTTTTTPPP
PPPTSSSBSSSSBBBSBBBSBBBSMSSSSSBTTBBBBBBBBBBBBBBTTTSSSSSMSTTTTTTTTSSTTTBBBBBBBBBBSSBBBBTTSSTTTTTTTPPP
PPPTTSSSSTSSBBBBBBBBBBBSMSSSSSBBBBBBBBBBBBBBBBTTTSSSSSSMSTTTTTTTTSSTTTBBBBBBBBBBBSSSSBTTSSTTTTTTTPPP
PPPTTTTSTSSBBBBBBBBBBBBSMSSSSSSSSSSSSBBBBBBBTTTTSSSSSSSMSTTTTTTTSSTTTTBBBBBBBBBBBBSSSSTTSSTTTTSSTPPP
PPPTTTTTTSSBBBBBBBBBBBBSMSSSSSSSSSSSSSSSBTTTTTTSSSSSSSSMSTTTTTTTTSSTTTBBBBBBBBBBBBBBBSSTSSSSTSSSSPPP
PPPTTTTTSSBBBBBBBBBBBBBSMMMMMMMMMMMMMMMMMTTTTSSSSSSSSSSMSTTTTTTTTSSTTTTTTTTTTTTTTTTTTTSSSSSSSSTTSPPP
PPPTTTTSSSSBBBBBBBBBBBBSSSSSSSSSSSSSSSSSMTSSSSSSSSSSSSSMSTTTTTTTTTSSTTTTTTTTTTTTTTTTTTTSSSTTSTTTTPPP
PPPTTTSSSSBBBBBBBBBBBBBBSSBBBBBBBBBTAATSMSSSSSSSSSSSSSSMSTTTTTTTTTSSTTTTTTTTTTTTTTTTTTTTSSTTTTTTTPPP
PPPTTTSSSSTTTTTTTTTBBBBSSBBBBBBBBBBTAATSMSSSSSSSSSSSSSSMSTTTTTTTTSSTTTTTTTTTTTTTTTTTTTTTTTTTTTTTTPPP
PPPTTSSSSTTTTTTTTTTBBBSSBBBBBBBBBBBTAATSMSSSSSSSSSSSSSSMSBBBBBBBSSTTTTTTTTTTTTTTTTTTTTTTTTTTTTTTTPPP
PPPTSSTTSSTTTTTTTKTBBBBSSSSSSSSSSSSSSSSSMSSSSSSSSSSSSSSMSBBBBBBSSAATTTTTTTTTTTTTTTTTTTTTTTTTTTTTTPPP
PPPTSSTTTSSTTTTTTTTBBBBSMMMMMMMMMMMMMMMMMSSSSSSSSSSSSSSMSBBBBBBBSSBBBBBBBBBBBBBBBBTTTTTTTTTTTTTTTPPP
PPPSSTTTTTSSTTTTTTTBBBBSMSSSSSSSSSSSSSSSSSSSSSSSSSSSSSSMSBBBBBBSSSSBBBBBBBBBBBBBBBTTTTTTTTTTTTTTTPPP
PPPTSSTTTSSTTTTTTTTBBBBSMSSSSSSSSSSSSSSSSSSSSSSSSSSSSSSMSBBBBBBBSSSSBBBBBBBBBBBBBBTTTTTTTTTTTTTTTPPP
PPPSSTTTSSTTTTTTTTTBBBBSMSSSSSSSSSSSSSSMMMMMMMMMMMMMMMMMSBBBBBBSSTBSSBBBBBBBBBBBBBTTTTTTTTTTTTTTTPPP
PPPSSTTTTSSTTTTTTTTBBBBSMSMMMSSSMMMMSSSMSSSSSSSSSSSSSSSSSBBBBKSSAABBSSBBBBBBBBBBBBTTTTTTTTTTTTTTTPPP
PPPSSTTTTTSSTTTTTTTBBBBSMSSMSSSSMSSMSSSMSBBBBBBBBBBBBBBBBBBBBBBSSAASSBBSSSSSSSSSSSSSSSSSSTTTTTTTTPPP
PPPTTTTTTTSSTTTTTTTBBBBSMSSMSSSSMSSMSSSMSBBBBBBBBBBBBBBBBBBBBBBBSSSSBBBSSSSSSSSSSSSSSSSSSTTTTTTTTPPP
PPPTTTTTTSSTTTTTTTKBBBBSMSSMSSSSMSSMSSSMSBBBBBBBBBBBBBBBBBBBBBBBBSSBBBBSSSTTTSTTTSTSTSSSSTTTTTTTTPPP
PPPTTTTTSSTTTTTTTTTBBBBSMSSMSSSSMMMMSSSMSBBBBBBBBBBBBBBBBBBBBBBBSSBBBBBSSSSSTSTSTSTSTSSSSTTTTTTTTPPP
PPPTTTTTSSTTTTTTTTTBBBBSMSSMSSSSMSSMSSSMSBBBBBBBBBBBBBBBBBBBBBBBBSSBBBBSSSTTTSTSTSTSTTTSSTTTTTTTTPPP
PPPTTTTTSSTTTTTTTTTBBBBSMSSMSSSSMSSMSSSMSBKBBBBBBBBBBBBBBBBBBBBBBTSSBBBSSSTSSSTSTSTSTSTSSTTTTTTTTPPP
PPPTTTTTTSSTTTTTTTTTTBBSMSMMMSKSMSSMSKSDSBBBBBBBBBBBBBBBBBBBBBBBBSSBBBBSSSTTTSTTTSTSTTTSSTTTTTTTTPPP
PPPTTTTTSSTTTTTTTTTTTBBSMSSSSSSSSSSSSSSDSBBBBBBBBBBBBBBBBBBBBBBBSSBBBBBSSSSSSSSSSSSSSSSSSTTTTTTTTPPP
PPPTTTTSSTTTTTTTTTTTTBBSMSSSSSSSSSSSSSSDSBBBBBBBBBBBBBBBBBBBBBBBBSSBBBBSSSSSSSSSSSSSSSSSSTTTTTTTTPPP
PPPTTTSSTTTTTTTTTTTTTBBSMSSSSSSSSSSSSSSMSTTTTTTTTTTTTTTTTTTTTTTTTTSSBBBSSSPPPPPPPPPPPSSPPPPPPPPPPPPP
PPPTTTTSSTTTTTTTTTTTTBBSMMMMMMMMMMMMMMMMSTTBBBBBBBBBBBBBBTTTTTTTTAASSBBSSSPPPPPPPPPPPSSPPPPPPPPPPPPP
PPPTTTTSSTTTTTTTTTTTTBBSSSSSSSSSSSSSSSSSSTTBBBBBBBBBBBBBBTTTTTTTTTAASSTSSSPPMMMMMMMMMDDMMMMMMMMMMPPP
PPPTTTTSSTTTTTTTTTTTTBSSBBBBBBBBBBBBBBBBTTTBBBBBBBBBBBBBBTTTTTTTTSSSSTTSSSPPMSSSSSSSSSSTTTTTTTTTMPPP
PPPTTTSSTTTTTTTTTTTTTBSSBBBBBBBBBBBBBBBBTTTBBBBBBBBBBBBBBTTTTTTTSSTSSTTSSSPPMSSSSSSSSSSSTTTTTTTTMPPP
PPPTTTSSTTTTTTTTTTTTTBBSSBBBBBBBBBBBBBBBTTTBBKBBBBBBBBBBBTTTTTTTTSSSSTTSSSPPMSSSSSSSSSSSSTTTTTTTMPPP
PPPTTTTSSTTTTTTTTTTKTTTTMMMMMMMMMMMMMMMMMMMMMMMMMMMMMMMMMMMMMTTTSSTSSTTSSSPPMSSSSSSSSSSTSSTTTTTTMPPP
PPPTTTSSTTTTTTTTTTTTTTTTSSBBBBBBBBBBBBBBTTTBBBBBBBBBBBBBBTTTMTTTSSAASSTTTTAAATTTTTTSSTTTTSSTTTTTMPPP
PPPTTTSSATTTTTTTTTTTTTTSSBBBBBBBABAAKBBBTTTBBBBBBBBBABBBBTTKMTTSSAATTSSTAAAAAAATATSSTTTTTTSTSTTTMPPP
PPPSTASSAATTTTAATTTTTTABSSBBBBBAAAAAABBBBBBBBBBBABBAAABABAATMTTATTAAASSAAAPPMAAAAASATAATTSSSSSSSMPPP
PPPSSASSTAAAAAAAAATTTAAASSBBABAABABBAAABBBBBBBBAAAAABAAAAAAAMSSATTTAASSASTPPMTTATAAAAAATSSSSASSSMPPP
PPPTSTSSSTAAAATTAATTAATAABAAAAABBBBBBAAAABBBABAABAASBSABATTAMSSSSSSATSSSSSPPMTTTTTATATSSSTTTATTSMPPP
PPPTTSSTSSTTSTTTSSSSATTBAAAABABBBBBBBBBAAAAAAAASBSBSSSBBSTTSMTTSSSSSSTSSSSPPMTTTSSSTSSSSTTTTTTTTMPPP
PPPTTSSTSSSSSSTSSSSSSTSBBASSSBBBBSSSSBBBBAAASABSSSBSSBBSSSSSMTTSSTTSSSSTSTPPMSBSSSSSSSBBBBTTTTTTMPPP
PPPSSSSSSTSSTSSSTTTTSSSSSBSSSSBBSSSSSSBBBSSBSBBSSSSSSBSSMSMTMTSSTTTAASTTTTPPMSSSBBBSBBBBBBTTTTTTMPPP
PPPSSSSSTTTTTTSTTTTTTSTSSSSBBSSSSBSSSSBBSSSBSBSSBSSBSSSTMSMTMTTSSTTTTSSTTTPPMTSBBBBBBBBBBBTTTTTTMPPP
PPPTTTSSTTTTTTTTTTTTTTTBBSSSSSSSSSSSSSSSSSBSSSSBBBBBBSTTMTMTMTTSSTTTSSTTTTPPMTBBBBBBBBBBBBTTTTTTMPPP
PPPTTTTSSTTTTTTTTTTTTTTBBSSSSSBBSSBBBSSSSSSSBSBBBBBBBTTTMTMTMTSSTTTTSSTTTTPPMTBBBBBBBBBBBBTTTTTTMPPP
PPPTTTSSTTTTTTTTTTTTTTTBSSBBBBBBBBBBBBBBSBSBBBBBBBBBBTTTMTMTMTSSTTTTTSSTTTPPMTBBBBBBBBBBBBTTTTTTMPPP
PPPTTTTSSKTTTTTTTTTTTTTBMSSBBBMMMMMMMMMMMMMMMMMMMMMMMMMTMTMTMTSSTTTTSSTTTTPPMTBBBBBBBBBBBBTTTTTTMPPP
PPPTTTTTSSTTTTTTTTTTTTTTMSTTTTMTTTTTTTTTTTTTTTTKTTTTTTTTMTMTMSSTTTTSSTTTTTPPMTTTTTTTTTTTTTTTTTTTMPPP
PPPTTTTSSTTTTTTTTTTTTTTTMSTTTTMTTTTTTTTTTTTTTTTTTTTTTTTTMTMTMSSTTTTTSSTTTTPPMTTTTTTTTTTTTTTTTTTTMPPP
PPPTTTTTSSTTTTTTTTTTTTTTMSSTTTMTTTTTTTTTTTTTTTTTTTTTTTTTMTMMMSSTTTTTTSSTTTPPMTTTTTTTTTTTTTTTTTTTMPPP
PPPTTTTSSTTTTTTTTTTTTTTTMTSSTTMMMMMMMMMMMMMMMMMMMMMMTTTTMTTTSSTTTTTTSSTTTTPPMTTTTTTTTTTTTTTTTTTTMPPP
PPPTTTSSTTTTTTTTTTTTTTTTMTSSTTTTTTTTTTTTTTTTTTTTTTTMTTTTMTTSSTTTTTTTTSSTTTPPMTTTTTTTTTTTTTTTTTTTMPPP
PPPTTTTSSTTTTTTTTTTTTTTTMSSTTTTTTTTTTTTTTTTTTTTTTTTMTTTTMTTSSTTTTTTTAASSTTPPMKTTTTTTTTTTTTTTTTTKMPPP
PPPTTTTTSSTTTTTTTTTTTTTTMTSSTTTTTTTTTTTTTTTTTTTTTTTMTTTTMTTTSSTTTTTAASSTTTPPMMMMMMMMMMMMMMMMMMMMMPPP
PPPPPPPPPPPPPPPPPPPPPPPPPPPPPPPPPPPPPPPPPPPPPPPPPPPPPPPPPPPPPPPPPPPPPPPPPPPPPPPPPPPPPPPPPPPPPPPPPPPP
PPPPPPPPPPPPPPPPPPPPPPPPPPPPPPPPPPPPPPPPPPPPPPPPPPPPPPPPPPPPPPPPPPPPPPPPPPPPPPPPPPPPPPPPPPPPPPPPPPPP
PPPPPPPPPPPPPPPPPPPPPPPPPPPPPPPPPPPPPPPPPPPPPPPPPPPPPPPPPPPPPPPPPPPPPPPPPPPPPPPPPPPPPPPPPPPPPPPPPPPP
